0 0 0 0 0 0 0 0 0 0 0 0 0 0 0 0 0 0 0 0 0 0 0 0 0 0 0 0 0 0 0 0 0 0 0 0 0 0 0 0 0 0 0 0 0 0 0 0 0 0 0 0 0 0 0 0 0 0 0 0 0 0 0      
0 0 0 0 0 0 0 0 0 0 0 0 0 0	0 0	0 0	0 0	0 0	0 0	0 0	0 1	0 0	0 0 0 0 0 0 0 0 0 0 0 0 0 0 0 0	0 0	0 0	0 0	0 0	0 0	0 0	0 0	0 0	0
0 0 0 0 0 0 0 0 0 0 0 0 0 0	0 0	0 0	0 0	0 0	0 0	0 0	0 6	0 0	0 0 0 0 0 0 0 0 0 0 0 0 0 0 0 0	0 0	0 0	0 0	0 0	0 0	0 0	0 0	0 0	0
0 0 0 0 0 0 0 0 0 0 0 0 0 0	0 0	0 0	0 0	0 0	0 0	0 0	0 6	0 0	0 0 0 0 0 0 0 0 0 0 0 0 0 0 0 0	0 0	0 0	0 0	0 0	0 0	0 0	0 0	0 0	0
0 0 0 0 0 0 0 0 0 5 0 0 0 0	0 2	1 1	1 1	3 3	3 1	1 1	0 7	0 0	0 0 0 0 0 0 0 0 0 0 5 5 0 0 0 0	0 1	1 1	1 1	1 1	1 1	1 1	0 0	0 0	0
0 0 0 0 2 1 1 1 1 1 1 1 1 1	1 1	8 8	8 8	4 4	4 8	8 8	1 1	1 1	1 1 1 1 1 1 1 1 1 1 1 1 1 1 1 1	1 8	8 8	8 8	8 8	8 8	8 8	1 1	1 1	1
2 1 1 1 1 8 8 8 8 8 8 8 8 8	8 8	8 8	8 8	8 8	8 8	8 8	8 8	8 8	8 8 8 8 8 8 8 8 8 8 8 8 8 8 8 8	8 8	8 8	8 8	8 8	8 8	8 8	8 8	8 8	8
0 0 0 0 0 0 0 0 0 0 0 0 0 0	0 0	0 0	0 0	0 0	0 0	0 0	0 0	0 0	0 0 0 0 0 0 0 0 0 0 0 0 0 0 0 0	0 0	0 0	0 0	0 0	0 0	0 0	0 0	0 0	0
0 0 0 0 0 0 0 0 0 0 0 0 0 0	0 0	0 0	0 0	0 0	0 0	0 0	0 0	0 0	0 0 0 0 0 0 0 0 0 0 0 0 0 0 0 0	0 0	0 0	0 0	0 0	0 0	0 0	0 0	0 0	0
0 0 0 0 0 0 0 0 0 0 0 0 0 0	0 0	0 0	0 0	0 0	0 0	0 0	0 0	0 0	0 0 0 0 0 0 0 0 0 0 0 0 0 0 0 0	0 0	0 0	0 0	0 0	0 0	0 0	0 0	0 0	0
0 0 0 0 0 0 0 0 0 0 0 0 0 0	0 0	0 0	0 0	0 0	0 0	0 0	0 0	0 0	0 0 0 0 0 0 0 0 0 0 0 0 0 0 0 0	0 0	0 0	0 0	0 0	0 0	0 0	0 0	0 0	0
0 0 0 0 0 0 0 0 0 0 0 0 0 0	0 0	0 0	0 0	0 0	0 0	0 0	0 0	0 0	0 0 0 0 0 0 0 0 0 0 0 0 0 0 0 0	0 0	0 0	0 0	0 0	0 0	0 0	0 0	0 0	0